11 9
4    67   77   22   22   22   22   22   25   67   86
22   22   22   22   22   22   22   22   22   22   22 
174  174  174  174  174  174  174  174  174  174  174
22   22   22   22   22   161  22   22   22   22   22
22   114  22   22   22   161  22   22   22   135  22
22   22   22   22   22   161  22   22   22   22   22
174  174  174  174  174  174  174  174  174  174  174
22   22   22   22   22   22   22   22   22   22   22 
64   67   78   22   22   22   22   22   51   67   79