11 9
3    65   74   21   21   21   21   21   24   65   83
21   21   21   21   21   21   21   21   21   21   21 
170  170  170  170  170  170  170  170  170  170  170
21   21   21   21   21   157  21   21   21   21   21
21   110  21   21   21   157  21   21   21   131  21
21   21   21   21   21   157  21   21   21   21   21
170  170  170  170  170  170  170  170  170  170  170
21   21   21   21   21   21   21   21   21   21   21 
63   65   75   21   21   21   21   21   50   65   76