24 14
 51   67   78  132  161  141  141  141  141  141  132  132  165  132  132  132  132  132  132  132  132  141  141  141  
132  132  132  132  161  132  141  141  136  132  174  174  165  174  174  174  174  174  174  174  132  132  141  141  
 55   67   87  132  161  132  132  132  132  132  174  132  165  132  132  174  132  132  132  174  132  132  132  141  
132  132  132  132  161  132  132  132  132  132  174  132  165  132  132  132  132  135  132  174  132  132  132  132  
135   67   86  132  161  132  174  174  174  174  174  132  165  132  132  174  132  132  132  174  132  132  132  132  
132  132  132  132  161  132  174  132  132  132  174  132  165  132  132  174  174  174  174  174  132  132  136  132  
161  161  161  161  161  132  174  132  114  132  132  132  165  174  174  174  132  132  132  132  132  132  132  132  
132  132  132  136  132  132  174  132  132  132  174  132  165  165  165  165  165  165  165  165  165  165  165  165  
132  132  132  132  132  132  174  174  174  174  174  132  132  132  132  174  132  132  132  132  132  132  132  132  
132  132  141  132  132  132  132  132  132  132  174  132  132  132  132  174  132  132  132  132  136  132  132  132  
132  141  141  141  132  132  132  132   64  132  174  132  132  132  132  174  132  132  136  132  132  132  132  132  
132  132  141  141  132  132  132  132   67  132  174  174  174  174  174  174  132  132  132  132  132  132  132  132  
132  132  132  132  132  132  132  132   77  132  132  132  132  132  132  132  136  132  132  132  132  141  141  132  
132  132  132  132  132  132  132  132  132  132  132  132  132  132  132  132  132  132  132  141  141  141  141  141  
