22 16
4    64   174  132  132  132  132  132  132  132  132  132  132  132  132  132  141  132  132  132  132  132
67   67   174  132  141  132  132  174  174  174  174  174  174  174  174  132  141  132  132  132  132  132
77   78   174  132  132  132  132  174  170  170  170  170  170  170  174  132  132  132  132  132  132  132
174  174  174  132  132  141  132  174  170  114  170  170  161  170  174  132  132  132  132  132  132  132
132  132  132  132  132  132  65   174  170  170  170  170  170  170  174  132  132  132  132  132  132  132
132  132  132  141  141  132  67   174  170  170  170  170  161  170  174  132  132  132  132  132  132  132
132  132  132  132  132  132  88   174  170  170  170  170  170  170  174  132  132  132  132  132  132  132
141  132  132  132  174  174  174  174  175  175  175  174  174  174  174  174  174  174  132  141  132  132
132  141  132  132  174  132  132  132  132  132  132  174  132  132  132  132  132  174  132  132  132  132
132  132  132  132  174  132  132  132  132  132  132  174  132  51   67   79   132  174  132  132  141  132
132  132  132  132  174  132  132  132  132  132  132  174  132  132  132  132  132  174  132  132  132  132
132  132  132  132  174  175  175  175  132  174  132  132  132  132  132  132  132  174  132  132  132  132
132  141  141  132  174  175  175  175  132  132  132  174  132  25   67   86   132  174  141  132  132  132
132  141  141  132  174  135  175  175  132  132  132  174  132  132  132  132  132  174  132  132  141  141
132  132  132  132  174  174  174  174  174  174  174  174  174  174  174  174  174  174  132  132  141  132
132  132  132  132  132  132  132  132  132  132  132  132  132  132  132  132  132  132  132  132  132  132