33 18
64   67   78   150  150  132  174  132  132  132  132  132  174  132  132  132  174  132  132  132  150  150  150  150  150  150  150  132  132  132  132  132  132
150  150  150  150  132  132  174  132  132  132  132  132  132  132  114  132  174  132  132  150  150  150  150  150  150  150  132  132  132  132  132  132  132
150  150  132  132  132  132  174  132  132  132  132  132  174  132  132  132  174  132  132  150  150  150  150  150  150  132  132  132  132  132  132  132  132
150  132  132  132  132  132  174  132  4    67   77   132  174  174  174  174  174  132  150  150  150  150  150  150  150  132  132  132  132  132  132  132  132
132  132  132  132  132  132  174  174  132  132  132  174  174  132  132  132  132  132  150  150  150  150  150  150  132  132  132  132  132  132  132  132  132
132  132  132  132  132  132  174  132  132  132  132  132  161  132  132  132  132  132  150  150  150  150  150  150  132  132  132  132  132  132  132  132  132
132  132  132  132  132  132  174  174  174  174  174  174  174  132  132  132  132  150  150  150  150  150  150  150  132  132  132  132  132  132  132  132  132
132  132  132  132  132  132  174  51   174  132  132  132  132  132  132  132  132  150  150  150  150  150  150  132  132  132  132  132  132  132  132  132  132
132  132  132  132  132  132  132  67   132  132  132  132  132  132  132  132  132  150  150  150  150  150  150  132  132  132  132  132  132  132  132  132  132
132  132  132  132  132  132  132  79   132  132  132  132  132  132  132  132  150  150  150  150  150  150  150  132  132  132  132  132  132  132  132  132  132
132  132  132  132  132  132  132  132  132  132  132  132  40   132  132  132  150  150  150  150  150  150  132  132  132  132  132  132  132  132  132  132  132
132  132  132  132  132  132  132  132  132  132  132  132  132  132  132  150  150  150  150  150  150  132  132  132  132  132  132  132  132  132  132  132  132
132  132  132  132  132  132  132  174  4    67   90   174  132  132  132  150  150  150  150  150  150  132  132  132  132  132  135  132  132  132  132  132  132
132  132  132  132  132  132  132  174  174  174  174  174  132  132  150  150  150  150  150  150  132  132  132  132  132  132  132  132  132  132  132  132  132
132  132  132  132  132  132  132  174  40   67   89   174  132  132  150  150  150  150  150  132  132  132  132  132  132  25   67   86   132  132  132  132  132
132  132  132  132  132  132  132  174  174  174  174  174  132  150  150  150  150  150  150  132  132  132  132  132  132  132  132  132  132  132  132  132  150
132  132  132  132  132  132  132  132  132  132  132  132  150  150  150  150  150  150  132  132  132  132  132  132  132  132  132  132  132  132  132  150  150
132  132  132  132  132  132  132  132  132  132  132  150  150  150  150  150  150  150  132  132  132  132  132  132  132  132  132  132  132  132  150  150  150